W W W W W W W W W W W W W W W W W W W
W S S S E E E E E E E E E E E S S S W
W S 1 W E E E E E E E E B E E W 2 S W
W S W W E E S S S E E E E E E W W S W
W E E E E E E S S S E E E E E E E E W
W E E E W W W W W S E E E E E E E E W
W E E E E E E E E S E E E E E E E E W
W E B E W E E E E S E E E W W W W E W
W E S E W E S E E E E E E W E B S E W
W E S S W E S E S E E E E W E S S E W
W E E S W E E E E E E E E E E E E E W
W E W W E E E E E W W E E E W E E E W
W E E E E E E E P E E E E E E E S S W
W E E E E E W W W W W E E E E E S S W
W E E E E E E E E E E E E E E E S S W
W E E E E S S S E E S S W E W E E E W
W E E E E E E E E E E E E E E E E E W
W S W W E E W W W W E E E E E W W S W
W S 1 W E E S S S W W W W E E W 2 S W
W S S S E E E S S W S S E E E S S S W
W W W W W W W W W W W W W W W W W W W