W W W W W W W W W W W W W W W W W W W
W E E S S E E E E S S E E E E E E E W
W E S E E W E E E S W E E S S E E E W
W E E E 1 W E E E S W E E E W S E E W
W E E W W W E E E E W E E E W E S E W
W E E E E E E E E E E E E E W E E E W
W E E E E E E E E E E E E E W B E E W
W E E S S E W W W W W E E E E E E E W
W E E E E E S E E E E E E E E E E E W
W E E W E E E E S S S E E E E E E E W
W E E W E E E E E E E E E E E E E E W
W E E W E E W W W E E E E W W W W W W
W E S W E E W E P E E E E W S S E B W
W E S W E S E E E E E E E W S E S E W
W E S W E S E E W E E E E W E S E E W
W E E W E E E W S W E E E E E E E E W
W E E E E E E E E E E E E W W W E E W
W E E E E E E E E E S E E W 2 E E E W
W E B E W W W W W E S E E W E E S S W
W E E E S S S S S S E E E S S S S E W
W W W W W W W W W W W W W W W W W W W